#####
##B##
## ##
#   #
# # #
#   #
## ##
##A##
#####