#####
# #B#
# # #
#   #
## ##
## ##
##A##
#####