#####
#   #
# #B#
# # #
#   #
## ##
##A##
#####