#####
###B#
### #
### #
#   #
# ###
# ###
#A###
#####